***S*
*   *
* ***
*   *
*** *
*   *
*G***