***S*
*   *
* ***
*   *
*** *
    *
G****